WWWWWWWWWWWWWWWWWWWWWWWWW
WW--------------P-WWWWWWW
WWWWWW---------------WWWW
W---WWWWWWWWWWWWW---WWWWW
WWWWW--WWW-----WW--WWWWWW
WWWWW----------WW--WWWWWW
WWWWWWWWWWWW----------WWW
WW----WWWW----------WWWWW
W-------WW---WWWWWWWWWWWW
WE-WW------------WWWWWWWW
WWWWWWW----------WWWWWWWW
WWWWWWWWWWWWWWWWWWWWWWWWW