WWWWWWWWWWWWWWWWWWWWWWWWW
WW--------------P-WWWWWWW
WWWWWW---------------WWWW
W---WWWWWWWWWWWWW--WWWWWW
WWWWW--WWW-----WW--WWWWWW
WWWWW----------WW--WWWWWW
WWWWWWWWWWWW----------WWW
WW----WWWW----------WWWWW
W-------WW---WWWWWWWWWWWW
W--WW------------WWWWWWWW
WWWWWWW----------WWWWWWWW
WWWWWWWWWWWWWWWWWWWWWWWWW