WWWWWWWWWWWW
W---P------W
W----------W
WWWWWWW----W
WWWWW----WWW
WWWWW----WWW
W----W---WWW
WWWWWW----WW
WWW-----WWWW
WWW-----WWWW
W----WWWWWWW
W----WWWWWWW
WWWWWWW---WW
WWWWWWWWWWWW