WWWWWWWWWWWWWWWWWWWWWWWWW
WWP--------WWWWWWWWWWWWWW
WW--------WWWW-------WWWW
WWWWWW---------------WWWW
W---WW--------------WWWWW
W---WW----WWWWW-----WWWWW
WWWWWW---WWWWWWWW---WWWWW
WWWWWWWWWWWW----------WWW
WW----WWWW----------WWWWW
W-------WWWWW-------WWWWW
W--WW------------WWWWWWWW
W--WW--------------WWWWWW
WWWWWWW-W---W------EWWWWW
WWWWWWWWWWWWWWWWWWWWWWWWW