WWWWWWWWWWWW
W---P------W
W----------W
WWWWWWW----W
WWWWW----WWW
WWWWW----WWW
W----WWWWWWW
WWWWWW----WW
WWW----WWWWW
W----WWWWWWW
WWWWWWW---WW
WWWWWWWWWWWW